####################
#..................#
#..................#
#..................#
#.............P....#
#.............#....#
#S..GgCCCCY......pE#
######yyyy##########
######^^^^##########
####################
3
10
1,1