#..................#
#..................#
#..................#
#..................#
#..................#
#........C.........#
#..................#
#.S..............E.#
#########^##########
####################
5
10
0,1