####################
#..................#
#..................#
#..................#
#..S..CC...........#
#####....CC........#
#####.......CC..E..#
#####..........#####
#####..........#####
####################
3
10
1,0,1
6