####################
###..............###
###.S............###
#######..........###
#######......CCCC###
###..........#######
###.E........#######
#######......#######
#######......#######
####################
3
12
1,0,1
4