####################
####################
#...g..h..p..q.....#
#...g..h..p..q.....#
#...g..h..p..q.....#
#...g..h..p..q..CCE#
#...g..h..p..q..####
#S.Gg.Gh.Pp.Pq..####
####################
####################
3
2
0,1
2
