....................
....................
....................
....................
....................
....................
....................
....................
#S................E#
#######....#########
5
15
