#.............vv...#
#..................#
#>......C..C......<#
#>................<#
#..................#
#.S..............E.#
######...g....######
######...g....######
######G..g....######
####################
3
10
1,1