####################
#....vvvv..........#
#>.................#
#>................<#
#>................<#
#>................<#
#....CCC...........#
#S................E#
#####^^^############
####################
3
10
1,1