####################
#..................#
#..................#
#..................#
#..................#
#..S....CCCC....E..#
######........######
######........######
######........######
####################
3
8
1,0,1
4