####################
#..G#h.............#
#..##h.............#
#....h......C......#
#S...hC...CC.C....E#
##########...#######
##########^^^#######
####################

3
8
1,1
5
