....................
....................
....................
....................
....................
....................
....................
SG....P.....Y......E
##hh###qq####zz#####
##..###..####..#####
3
10
1,1